D------PPPP-----
P------P--P-----
PPPPPPPP--P-----
P---------P-----
PPPPPPPPPPP-----
---P------P-----
---P------P-----
---P------P-----
---P------PPPPP-
---PPPPP------P-
-------PPPPPPPP-
-------P------P-
-------P------P-
-------PPPPP--PP
-----------PPPPA