D------PPPP-PP--
P------P--PPP---
PPPPPPPP--P-----
P---------PPPP--
PPPPPPPPPPP--P--
---P---P---PPP--
---P-P-P--P-----
---P-PPP--P-----
---P------PPPPP-
---PPPPP------P-
--P-PP-PPPPPPPP-
--P-P--PP-----PP
--P-P---P------P
--P-P---PPPPP--P
--PPPP-----PPPPA